NO textures/Standard/1.png
SO textures/Standard/2.png
WE textures/Standard/3.png
EA textures/Standard/4.png

F 100,100,0
C 225,100,225

111111111111111111
1000000S0011100001
100000000011100111
1000000000111001
1110000000010001
1110000100010001
1110000000011001
1010000000001001
1010000000001101
1000000000000001
1111111111111001
1111111111111111
1              1
1111111111111111
